NO ./src/texture/north_texture.xpm
SO ./src/texture/south_texture.xpm
WE ./src/texture/west_texture.xpm
EA ./src/texture/east_texture.xpm
C 0,180,0
F 0,140,10

1111111111111111
1000000000000001
100000W000000001
1000000000000001
1111111111111111