NO ./src/texture/north_texture.xpm
SO ./src/texture/south_texture.xpm
WE ./src/texture/west_texture.xpm
EA ./src/texture/east_texture.xpm
F 222,10,255
C 225,230,255

1111111111111111111111111111
1000000000000000000000000111
1000000000000000000000000001
1000W00000000000000000000001
1000000000000000000000000111
1000000000000000000000000111
1000000000000000000000000111
1000000000000000000000000111
1000000000000000000000000111
1000000000000000000000000011
1111111111111111111111111111
