NO ./src/texture/north_texture.xpm
SO ./src/texture/south_texture.xpm
WE ./src/texture/west_texture.xpm
EA ./src/texture/east_texture.xpm
C 134,188,225
F 49,27,12

11111111111111111111111111111111111111111111111
10000000000000000000000000000000000000000001111
1000000000111111110000000000000000000000000011111111
1100000000111111110000000000000000000000000000000001111111
110000000011000000000000000000011001000000000000000000000111
110000000011111000000000000000100001000000000000000000000011111111111111111111111
11000000001111100S0000000000010000000100000000000000000000000000000000000000000011
110000000011100000000000000010000001000000000000000000000000000000000000000000111
1100000000111000000000000000001000000001000000000000000000000000000000000000000011
110000000011100000000000000000010000000100000000000000000000000000000000000000111
11000000001111000000000000000000010000000000000000000000000000000000000000000111
110000000000000000000000000000000000000000000000000000000000000000000000000011
11111111111111111111111111111111111111111111111111111111111111111111111111111