NO ./src/texture/north_texture.xpm
SO ./src/texture/south_texture.xpm
WE ./src/texture/west_texture.xpm
EA ./src/texture/east_texture.xpm
C 0,180,0
F 0,140,10

1111111111111111111111111111
1000010000000100000000000111
10001N1000000010000000000001
1001110010000001000000000001
10000000100000000100000000111
10000001000100000010000000111
1111010000010000000000000111
11110100000001000000000000111
11110000000000000000000111
1000000000100000000000000011
1111111111111111111111111111
