NO ./src/texture/north_texture.xpm
SO ./src/texture/south_texture.xpm
WE ./src/texture/west_texture.xpm
EA ./src/texture/east_texture.xpm
C 0,180,0
F 0,140,10

1111111111111111111111111111
1100000000000000000000000111
110000000N10000000001000001
1110000000000000000000110001
1111111111111111111111111111
