NO ./src/texture/north_texture.xpm
SO ./src/texture/south_texture.xpm
WE ./src/texture/west_texture.xpm
EA ./src/texture/east_texture.xpm
C 134,188,225
F 49,27,12

1111111111111111
1001000000000011
11000E0000000000111
110000000000000000011
1100000000000000000000011
110000000000000000000000011
110000000000000000000000000000000000000000000011
1100000000000000000000000000000000000000000000011
110000000000000000000000000000000000000000000011
11000000000000000000000000000000000000000000011
1100000000000000000000000000000000000000000011
1100000000000000000000000000000000000000000011
11111111111111111111111111111111111111111111