            NO ./src/texture/north_texture.xpm

SO ./src/texture/south_texture.xpm
WE ./src/texture/west_texture.xpm
EA                        ./src/texture/east_texture.xpm
C 134,188,225
F 49,27,12

1111111111111111111111111111111111111111111111111111111111111
111111111111111110000000000000000000000000000000000000000001111
                11111111000000000000000000111111111111111111111
               11111111111100000000111111110000000000000000001111111
1111111111111111000000000000000000011001000000000000000000000111
1111111111111111000000000000111100001000000000000000000000011111111111111111111111
            11000000001111101W10000000000100000001000000000000000000000000000000011
1111111111111111110000000011101000000000000010000001000000000000000000000000000000111
11111111111100000000111000011010000000010000000010000000000000000000000000000000011
11111111111111000000001110000000000000000001000000010000000000000000000000000000111
110000000011110000000000000000000100000000000000000000000000000000000000000001111
110000000000000000000000000000000000000000000000000000000000000000000000000011
11111111111111111111111111111111111111111111111111111111111111111111111111111