NO ./src/texture/north_texture.xpm
SO ./src/texture/south_texture.xpm

C 134,188,225
EA ./src/texture/east_texture.xpm
F 49,27,12
WE ./src/texture/west_texture.xpm

11111111111111111111111111111111111111111111111
10000000000000000000000000000000000000000001111
100E000000000000000000000000000000000000000000111111
1100000000000000000000000000000000000000000000000001111111
110000000000000000000000000000011001000000000000000000000111
110000000000000000000000000000100001000000000000000000000011111111111111111111111
1100000000000000000000000000010000000100000000000000000000000000000000000000000011
110000000000000000000000000010000001000000000000000000000000000000000000000000111
1100000000000000000000000000001000000001000000000000000000000000000000000000000011
110000000000000000000000000000010000000100000000000000000000000000000000000000111
1100000000000000000000000000000010000000000000000000000000000000000000000000111
110000000000000000000000000000000000000000000000000000000000000000000000000011
11111111111111111111111111111111111111111111111111111111111111111111111111111