NO ./src/texture/north_texture.xpm
SO ./src/texture/south_texture.xpm
WE ./src/texture/west_texture.xpm
EA ./src/texture/east_texture.xpm
F 222,10,255
C 225,230,255
111111111111111
10000W01111111
1000001111111
11111111
